      #####
    ##     ##
   #         #
  #        X  #
 #        ###  #
#        #   #  #
#   ###  # O #  #
#  # P # #   #  #
#         # #   #
#               #
#               #
#    O##O##X    #
 #     ###     #
  #           #
   #    X    #
    ##     ##
      #####