              #####
              #   #
    #####     #   #######
    #   ##### #   OOOOO #
##### # ##  # #     # # #
# X X X X X # ##   ## X #
# # ##OOOOOO#### ### XX ###
#P     ## O #    # #  XX  #
##########OXX   ## #      #
         #OX X# #  ########
         #O##   #
         ########